name:C N Red Imperial Red Ale; factoryRedwood Lodge; style:American Amber / Red Ale; ABV:8.10 %	name:Kinetic Infrared Imperial Red Ale; factoryKinetic Brewing Company; style:American Strong Ale; ABV:9.30 %	different
name:Sanibel Red Island Ale; factoryPoint Ybel Brewing Company; style:American Amber / Red Ale; ABV:5.60 %	name:Point Ybel Sanibel Red Island Ale; factoryPoint Ybel Brewing Company; style:Irish Ale; ABV:5.60 %	consistent
name:Kniksen India Red Ale; factory7 Fjell Bryggeri; style:American Amber / Red Ale; ABV:6.80 %	name:Boneyard Skunkape India Red Ale; factoryBoneyard Beer Company; style:India Pale Ale &#40; IPA &#41;; ABV:6.50 %	different
name:Buffalo Trace Bourbon Barrel Aged Amber Ale; factoryWolf Hills Brewing Company; style:American Amber / Red Ale; ABV:-	name:Ballast Point Calico Amber Ale - Rum Barrel Aged; factoryBallast Point Brewing Company; style:Amber Ale; ABV:5 %	different
name:Poor Richard 's Ale; factoryDry Dock Brewing Co. .; style:American Amber / Red Ale; ABV:6.50 %	name:21st Amendment Poor Richards Ale; factory21st Amendment Brewery; style:Traditional Ale; ABV:7 %	consistent
name:Redeemer Imperial Red Ale; factoryBoston Beer Works - Canal Street; style:American Amber / Red Ale; ABV:8.20 %	name:Laurelwood Organic Deranger Imperial Red Ale; factoryLaurelwood Public House & Brewery; style:American Strong Ale; ABV:8.60 %	different
name:Big Axe Red Ale; factoryBig Axe Brewing Company; style:American Amber / Red Ale; ABV:6.80 %	name:Big Spruce Ready Yer Knot ... Regatta Red Ale; factoryBig Spruce Brewing; style:Amber Ale; ABV:-	different
name:Roundabout Imperial Red Ale; factoryBonfire Brewing Co. .; style:American Amber / Red Ale; ABV:8.80 %	name:Anacapa Riptide Imperial Red Ale; factoryAnacapa Brewing Company; style:American Strong Ale; ABV:8 %	different
name:Merry Prankster Imperial Red Ale; factoryRock Bottom Restaurant & Brewery; style:American Amber / Red Ale; ABV:4.56 %	name:Tumbledown Imp Imperial Red Ale; factoryTumbledown Brewing LLC; style:American Strong Ale; ABV:7.80 %	different
name:Extra Special Red Ale; factoryAlpha Brewing Company; style:American Amber / Red Ale; ABV:5.00 %	name:Ecliptic Phobos Extra Red Ale; factoryEcliptic Brewing; style:Amber Ale; ABV:5.20 %	different
name:Aorta Ale ( Double Red Ale ); factoryShort 's Brewing Company; style:American Amber / Red Ale; ABV:8.30 %	name:Destihl Barrel Aged Deadhead Double Red Ale; factoryDestihl Brewery; style:American Strong Ale; ABV:-	different
name:Three Sheets Barleywine ( Barrel Aged ); factoryBallast Point Brewing Company; style:American Barleywine; ABV:9.00 %	name:&#40; 512 &#41; Cabernet Barrel Aged Three; factory&#40; 512 &#41; Brewing Company; style:Abbey Tripel; ABV:9.50 %	different
name:Peak Organic The Maple Collaboration; factoryPeak Organic Brewing Company; style:American Amber / Red Ale; ABV:7.00 %	name:Peak Organic The Maple Collaboration; factoryShipyard Brewing Company; style:Amber Ale; ABV:6.70 %	consistent
name:Bourbon Barrel Red Oak Ale; factoryTornado Brewing Company; style:American Amber / Red Ale; ABV:-	name:Ballast Point Tongue Buckler Imperial Red Ale - Bourbon Barrel Aged; factoryBallast Point Brewing Company; style:American Strong Ale; ABV:10 %	different
name:John Barleycorn - Bourbon Barrel Aged; factoryMad River Brewing Company; style:American Barleywine; ABV:12.50 %	name:AleSmith Old Numbskull - Bourbon Barrel Aged; factoryAleSmith Brewing Company; style:Barley Wine; ABV:11 %	different
name:Royal Amber Ale; factoryHops Grillhouse & Brewery; style:American Amber / Red Ale; ABV:4.50 %	name:Kalamazoo Royal Amber Ale; factoryBells Brewery; style:Amber Ale; ABV:-	consistent
name:The Gentle Mongoose; factoryHoly City Brewing; style:American Amber / Red Ale; ABV:6.90 %	name:Holy City The Gentle Mongoose; factoryHoly City Brewing; style:Amber Ale; ABV:6.90 %	consistent
name:Hop Around Imperial Red Ale; factoryBig Bay Brewing Co. .; style:American Amber / Red Ale; ABV:9.00 %	name:ShuBrew Heart and Sole Imperial Red Ale; factoryShuBrew; style:American Strong Ale; ABV:6.80 %	different
name:3 Sisters American Red Ale; factoryWild Ride Brewing Co. .; style:American Amber / Red Ale; ABV:6.00 %	name:Saimaan Brewer_s Special American Red Ale; factorySaimaan Juomatehdas; style:Amber Ale; ABV:4.70 %	different
name:Dread Double Red Ale; factoryBullfrog Brewery; style:American Amber / Red Ale; ABV:7.80 %	name:Wildcard Double Down Imperial Red Ale; factoryWildcard Brewing Company; style:American Strong Ale; ABV:7.50 %	different
name:Mountain Series : Love Rhino ( Imperial Red Ale ); factoryBreckenridge Brewery; style:American Amber / Red Ale; ABV:8.90 %	name:Madhouse Venture Series Oak Aged Imperial Red; factoryMadhouse Brewing Company; style:American Strong Ale; ABV:8.50 %	different
name:Cow Catcher Red; factoryMountain Town Station Brewing Co. & Steakhouse; style:American Amber / Red Ale; ABV:-	name:Mountain Town Cow Catcher Red Ale; factoryMountain Town Brewing Company; style:Amber Ale; ABV:5.80 %	consistent
name:Texas Red Amber Ale; factoryBig Texan Brewery; style:American Amber / Red Ale; ABV:4.50 %	name:William Street Red Sky Amber Ale; factoryWilliam Street Beer Co. .; style:Amber Ale; ABV:5 %	different
name:6th Anniversary Ale ( Dirty Hippie Imperial Red Ale ); factoryKern River Brewing Company; style:American Amber / Red Ale; ABV:8.00 %	name:Brew Bus Detour Series : Rollin Dirty Red Ale - Wood Aged; factoryCigar City Brewing; style:Irish Ale; ABV:5 %	different
name:Saint Gleason Imperial Red Ale; factoryAbita Brewing Co. .; style:American Amber / Red Ale; ABV:-	name:Mission Carrack Imperial Red Ale; factoryMission Brewery; style:American Strong Ale; ABV:10.20 %	different
name:Bourbon Barrel Ro Shampo Imperial Red Ale; factoryFigure 8 Brewing; style:American Amber / Red Ale; ABV:-	name:Sick N Twisted Naughty Redhead Imperial Red Ale; factorySick N Twisted Brewing Company; style:Amber Ale; ABV:8 %	different
name:Ruby River Ruby Red Ale; factoryRuby River Steakhouse & Brewery; style:American Amber / Red Ale; ABV:4.00 %	name:Pokertree Red Earl Ruby Ale; factoryPokertree; style:Amber Ale; ABV:5.50 %	different
name:Stone Liberty Station Outbreak Series : Red Ale; factoryStone Brewing Co. .; style:American Amber / Red Ale; ABV:7.00 %	name:Liberty High Point Rocket_s Red Ale; factoryLiberty Brewery & Grill - High Point; style:Irish Ale; ABV:-	different
name:Channary Imperial Red Ale; factoryNarrows Brewing Co. .; style:American Amber / Red Ale; ABV:9.40 %	name:Fulton The Libertine Imperial Red Ale - Heaven Hill Rye Whiskey Barrel Aged; factoryFulton Beer Company; style:American Strong Ale; ABV:8.50 %	different
name:Constanza _ â„¢ s Hoppy Red Ale; factoryBomber Brewing; style:American Amber / Red Ale; ABV:6.20 %	name:Spiteful Angry Adam Hoppy Red Ale; factorySpiteful Brewing; style:Amber Ale; ABV:6 %	different
name:Arsenal Imperial Red Ale; factoryGreat River Brewery; style:American Amber / Red Ale; ABV:9.00 %	name:Wynwood Fox Imperial Red Ale; factoryWynwood Brewing Company; style:American Strong Ale; ABV:7.70 %	different
name:Double Dragon Imperial Red Ale; factoryPhillips Brewing Company; style:American Amber / Red Ale; ABV:8.20 %	name:Edge Imperial Red Ale &#40; Spring Seasonal &#41;; factoryEdge Brewing Company; style:American Strong Ale; ABV:8.50 %	different
name:Bourbon Barrel Aged Auld Bitch; factoryTahoe Mountain Brewing Co. .; style:American Barleywine; ABV:11.00 %	name:Aspen Bourbon Barrel Aged Conundrum Red Ale; factoryAspen Brewing Company; style:Amber Ale; ABV:6.50 %	different
name:Kuhnhenn Extraneous Ale; factoryKuhnhenn Brewing Company; style:American Barleywine; ABV:17.00 %	name:Kuhnhenn Extraneous Ale; factoryKuhnhenn Brewing; style:Barley Wine; ABV:17.50 %	consistent
name:Lavery Imperial Red Ale; factoryLavery Brewing Company; style:American Amber / Red Ale; ABV:8.20 %	name:Oak Creek King Crimson Imperial Red Ale; factoryOak Creek Brewing Co. .; style:American Strong Ale; ABV:9.50 %	different
name:Broadhead Bourbon Barrel Aged Red; factoryBainbridge Island Brewing Company; style:American Amber / Red Ale; ABV:8.50 %	name:Ballast Point Tongue Buckler Imperial Red Ale - Bourbon Barrel Aged; factoryBallast Point Brewing Company; style:American Strong Ale; ABV:10 %	different
name:Ballistic Brewing Co. - Gorgon Red Ale; factoryIndian Wells Brewing Company; style:American Amber / Red Ale; ABV:5.50 %	name:Ballistic Brewing Gorgon Red Ale; factoryIndian Wells Brewing; style:Amber Ale; ABV:5.50 %	consistent
name:Hearthstone Red Rye Ale; factoryHearthstone Brewery; style:American Amber / Red Ale; ABV:5.00 %	name:Hearthstone Red Rye Ale; factoryHearthstone Brewery; style:Specialty Grain; ABV:5 %	consistent
name:River Otter Ale; factoryUnion Station Brewery; style:American Amber / Red Ale; ABV:5.10 %	name:Sacramento River Otter Ale; factorySacramento Brewing Company; style:English Pale Ale; ABV:5.50 %	consistent
name:Deputation Imperial Red Ale; factoryBrannon 's Pub and Brewery; style:American Amber / Red Ale; ABV:8.00 %	name:Yukon You Only Live Once Imperial Red Ale; factoryYukon Brewing Company; style:Amber Ale; ABV:7.50 %	different
name:Batch 200 _ `` Olympus Mons Imperial Red Ale; factoryDue South Brewing Co. .; style:American Amber / Red Ale; ABV:9.20 %	name:Three Heads Buffalo Soul Jah Imperial Red Ale; factoryCustom Brewcrafters; style:American Strong Ale; ABV:9.20 %	different
name:Climax Noel - Imperial Red Ale; factoryEel River Brewing Co. .; style:American Amber / Red Ale; ABV:9.20 %	name:Fulton The Libertine Imperial Red Ale - Heaven Hill Rye Whiskey Barrel Aged; factoryFulton Beer Company; style:American Strong Ale; ABV:8.50 %	different
name:Old Cascade Amber Ale; factoryRoosterfish Brewing Co. .; style:American Amber / Red Ale; ABV:5.50 %	name:Central Coast Old Mission Amber Ale; factoryCentral Coast Brewing; style:Amber Ale; ABV:5.50 %	different
name:Single Hop # 3 Amber Ale W / Citra; factoryThree Palms Brewing Co. .; style:American Amber / Red Ale; ABV:6.80 %	name:Lancaster Hop Buggy Amber Ale; factoryLancaster Brewing Co. .; style:Amber Ale; ABV:5.60 %	different
name:Bourbon Barrel Ro Shampo Imperial Red Ale; factoryFigure 8 Brewing; style:American Amber / Red Ale; ABV:-	name:Spring House Atomic Raygun Imperial Red Ale; factorySpring House Brewing Company; style:American Strong Ale; ABV:8.30 %	different
name:Red Dirt Imperial Red Ale; factoryWiley Roots Brewing Co; style:American Amber / Red Ale; ABV:8.20 %	name:Rock Bottom Orland Park King of Hearts Imperial Red Ale; factoryRock Bottom Orland Park; style:American Strong Ale; ABV:7.60 %	different
name:Bourbon Barrel Aged Redrum; factoryTrinity Brewhouse; style:American Amber / Red Ale; ABV:9.50 %	name:Aspen Bourbon Barrel Aged Conundrum Red Ale; factoryAspen Brewing Company; style:Amber Ale; ABV:6.50 %	different
name:Freedom Soho Red; factoryFreedom Brewery Ltd; style:American Amber / Red Ale; ABV:4.70 %	name:Freedom Soho Red; factoryFreedom; style:Amber Lager/Vienna; ABV:4.70 %	consistent
name:Heavyweight Ticklefight Champion Of The World; factorySolemn Oath Brewery; style:American Barleywine; ABV:12.00 %	name:Solemn Oath Heavyweight Ticklefight Champion of the World; factorySolemn Oath Brewery; style:Barley Wine; ABV:12 %	consistent
name:Barrel Aged Moustache Ride Red; factoryFlat 12 Bierwerks; style:American Amber / Red Ale; ABV:6.10 %	name:Fulton The Libertine Imperial Red Ale - Heaven Hill Rye Whiskey Barrel Aged; factoryFulton Beer Company; style:American Strong Ale; ABV:8.50 %	different
name:Neudorf Red Ale; factoryBrasserie Bendorf; style:American Amber / Red Ale; ABV:-	name:Bendorf Neudorf Red Ale; factoryBendorf; style:Irish Ale; ABV:6 %	consistent
name:Arthur 's Imperial Red Ale; factoryOtto 's Pub and Brewery; style:American Amber / Red Ale; ABV:6.90 %	name:Proof Abandoned Planet Imperial Red Ale; factoryProof Brewing Company; style:Amber Ale; ABV:7.50 %	different
name:Three Beavers Imperial Red Ale; factoryHowe Sound Inn & Brewing Company; style:American Amber / Red Ale; ABV:7.50 %	name:406 Imperial Red Ale; factory406 Brewing Company; style:American Strong Ale; ABV:9.20 %	different
name:Arthur 's Imperial Red Ale; factoryOtto 's Pub and Brewery; style:American Amber / Red Ale; ABV:6.90 %	name:Two Brothers Revelry Imperial Red Ale; factoryTwo Brothers Brewing Company; style:American Strong Ale; ABV:9.50 %	different
name:Red Dragon Smoked Amber Ale; factoryHoppy Brewing Co. .; style:American Amber / Red Ale; ABV:5.50 %	name:Baird Smoked Amber Ale; factoryBaird Brewing Co. .; style:Smoked; ABV:-	different
name:Batch 200 _ `` Olympus Mons Imperial Red Ale; factoryDue South Brewing Co. .; style:American Amber / Red Ale; ABV:9.20 %	name:Ale Mania Imperial Red Ale; factoryAle Mania &#40; Fritz Ale &#41;; style:American Strong Ale; ABV:9.50 %	different
name:Mr. Grain Jeans Organic Amber Ale; factoryOutpost Natural Foods; style:American Amber / Red Ale; ABV:5.50 %	name:Squatters Respect Your Mother Organic Amber Ale; factorySquatters Craft Beers; style:Amber Ale; ABV:4 %	different
name:Smuttynose Kindest Find Imperial Red Ale; factorySmuttynose Brewing Company; style:American Amber / Red Ale; ABV:8.50 %	name:Two Brothers Revelry Imperial Red Ale; factoryTwo Brothers Brewing Company; style:American Strong Ale; ABV:9.50 %	different
name:Broadhead Bourbon Barrel Aged Red; factoryBainbridge Island Brewing Company; style:American Amber / Red Ale; ABV:8.50 %	name:Flat 12 Barrel Aged Moustache Ride Red; factoryFlat 12 Bierwerks; style:Amber Ale; ABV:-	different
name:Pizza Orgasmica Amber Ale; factoryDevil 's Canyon Brewing Company; style:American Amber / Red Ale; ABV:6.50 %	name:Pizza Port Acacia Amber Ale; factoryPizza Port &#40; Solana Beach &#41;; style:Belgian Ale; ABV:-	different
name:Iron Mike 's Amber Ale; factoryJacob Leinenkugel Brewing Company; style:American Amber / Red Ale; ABV:-	name:Railway City Iron Spike Amber Ale; factoryRailway City Brewing Company; style:Amber Ale; ABV:4.60 %	different
name:Lagunitas Imperial Red Ale; factoryLagunitas Brewing Company; style:American Amber / Red Ale; ABV:7.80 %	name:Three Heads Buffalo Soul Jah Imperial Red Ale; factoryCustom Brewcrafters; style:American Strong Ale; ABV:9.20 %	different
name:Photobomb Imperial Red Ale; factoryCrooked Ladder Brewing Company; style:American Amber / Red Ale; ABV:8.50 %	name:Fulton The Libertine Imperial Red Ale - Heaven Hill Rye Whiskey Barrel Aged; factoryFulton Beer Company; style:American Strong Ale; ABV:8.50 %	different
name:Arthur 's Imperial Red Ale; factoryOtto 's Pub and Brewery; style:American Amber / Red Ale; ABV:6.90 %	name:Kinetic Infrared Imperial Red Ale; factoryKinetic Brewing Company; style:American Strong Ale; ABV:9.30 %	different
name:Red Rocket Amber Ale; factoryThird Base Sports Bar & Brewery; style:American Amber / Red Ale; ABV:6.40 %	name:Blue Cat Red Toad Amber Ale; factoryBlue Cat Brew Pub; style:Premium Bitter/ESB; ABV:5.70 %	different
name:Eruption Imperial Red Ale; factoryWorthy Brewing Co. .; style:American Amber / Red Ale; ABV:8.00 %	name:Three Heads Buffalo Soul Jah Imperial Red Ale; factoryCustom Brewcrafters; style:American Strong Ale; ABV:9.20 %	different
name:Barrel Aged Red Ale; factoryBearWaters Brewing Co. .; style:American Amber / Red Ale; ABV:6.70 %	name:Ballast Point Calico Amber Ale - Rum Barrel Aged; factoryBallast Point Brewing Company; style:Amber Ale; ABV:5 %	different
name:Ballistic Brewing Co. - Gorgon Red Ale; factoryIndian Wells Brewing Company; style:American Amber / Red Ale; ABV:5.50 %	name:Red Horn Coffee House and Brewing Company Red Horn Drink Well Red Ale; factoryRed Horn Coffee House and Brewing Company; style:Amber Ale; ABV:5.50 %	different
name:The `` Ginger '' A Red Ale; factoryElk Street Brewery & Tap Room; style:American Amber / Red Ale; ABV:6.80 %	name:The Beer Company Wyatt Earp Red Ale; factoryThe Beer Company; style:Irish Ale; ABV:7 %	different
name:North 45 Amber Ale; factoryPetoskey Brewing Company; style:American Amber / Red Ale; ABV:5.80 %	name:Thirsty Pagan North Coast Amber Ale; factoryThirsty Pagan Brewing; style:Amber Ale; ABV:-	different
name:Red 's On Vacation; factoryBarley John 's Brew Pub; style:American Amber / Red Ale; ABV:5.44 %	name:Barley Johns Reds on Vacation; factoryBarley Johns Brew Pub; style:Amber Ale; ABV:5.44 %	consistent
name:Old Cellar Dweller; factoryDriftwood Brewery; style:American Barleywine; ABV:11.60 %	name:Driftwood Old Cellar Dweller Barleywine; factoryDriftwood Brewery &#40; Canada &#41;; style:Barley Wine; ABV:14 %	consistent
name:Lavery Imperial Red Ale; factoryLavery Brewing Company; style:American Amber / Red Ale; ABV:8.20 %	name:Lagunitas Imperial Red Ale; factoryLagunitas Brewing Company &#40; Heineken &#41;; style:American Strong Ale; ABV:7.80 %	different
name:Double Dread Imperial Red Ale; factoryMad River Brewing Company; style:American Amber / Red Ale; ABV:8.60 %	name:Scuttlebutt Mateo Loco Imperial Red Ale; factoryScuttlebutt Brewing Co. .; style:American Strong Ale; ABV:7.10 %	different
name:Roundabout Imperial Red Ale; factoryBonfire Brewing Co. .; style:American Amber / Red Ale; ABV:8.80 %	name:AleSmith YuleSmith &#40; Winter &#41; Imperial Red Ale; factoryAleSmith Brewing Company; style:American Strong Ale; ABV:8.50 %	different
name:Port Chester Red Ale; factoryGreenpoint Beerworks / Kelso of Brooklyn; style:American Amber / Red Ale; ABV:5.50 %	name:Pizza Port Rhino Chaser Imperial Red Ale; factoryPizza Port &#40; Ocean Beach &#41;; style:American Strong Ale; ABV:9.50 %	different
name:Red Hopper ( Imperial Red Ale ); factoryBlack Acre Brewing Co. .; style:American Amber / Red Ale; ABV:6.20 %	name:Proof Abandoned Planet Imperial Red Ale; factoryProof Brewing Company; style:Amber Ale; ABV:7.50 %	different
name:Sons Of Anarchy Amber Ale; factorySudwerk Brewing Company; style:American Amber / Red Ale; ABV:4.70 %	name:Sudwerk Sons Of Anarchy Amber Ale; factorySudwerk Brewing Company; style:Amber Ale; ABV:4.70 %	consistent
name:Eldred Rock Amber; factoryHaines Brewing Company; style:American Amber / Red Ale; ABV:5.00 %	name:Haines Eldred Rock Amber; factoryHaines Brewing Co. .; style:Amber Ale; ABV:5 %	consistent
name:Double Dread Imperial Red Ale; factoryMad River Brewing Company; style:American Amber / Red Ale; ABV:8.60 %	name:406 Imperial Red Ale; factory406 Brewing Company; style:American Strong Ale; ABV:9.20 %	different
name:Blood On The Blade Red IPA; factoryBackpocket Brewing; style:American Amber / Red Ale; ABV:7.00 %	name:Bacchus / Burrow Bloodhound Blood Red IPA; factoryBacchus Brewing Company &#40; Australia &#41;; style:India Pale Ale &#40; IPA &#41;; ABV:6 %	different
name:My Hoppy Valentine; factoryExcel Brewing Company; style:American Amber / Red Ale; ABV:6.50 %	name:Excel My Hoppy Valentine; factoryExcel Brewing Company; style:Amber Ale; ABV:6.50 %	consistent
name:Hop Around Imperial Red Ale; factoryBig Bay Brewing Co. .; style:American Amber / Red Ale; ABV:9.00 %	name:Austin Beerworks Battle Axe Imperial Red Ale; factoryAustin Beerworks; style:American Strong Ale; ABV:8 %	different
name:6th Anniversary Ale ( Dirty Hippie Imperial Red Ale ); factoryKern River Brewing Company; style:American Amber / Red Ale; ABV:8.00 %	name:Tumbledown Imp Imperial Red Ale; factoryTumbledown Brewing LLC; style:American Strong Ale; ABV:7.80 %	different
name:Photobomb Imperial Red Ale; factoryCrooked Ladder Brewing Company; style:American Amber / Red Ale; ABV:8.50 %	name:ShuBrew Heart and Sole Imperial Red Ale; factoryShuBrew; style:American Strong Ale; ABV:6.80 %	different
name:C N Red Imperial Red Ale; factoryRedwood Lodge; style:American Amber / Red Ale; ABV:8.10 %	name:Ballast Point Tongue Buckler Imperial Red Ale; factoryBallast Point Brewing Company; style:American Strong Ale; ABV:10 %	different
name:Deranger Imperial Red Ale; factoryLaurelwood Public House & Brewery; style:American Amber / Red Ale; ABV:8.60 %	name:Renegade Scarlett Letter Imperial Red Ale; factoryRenegade Brewing Company; style:American Strong Ale; ABV:8.50 %	different
name:All American Red Ale; factoryCentennial Beer Co. .; style:American Amber / Red Ale; ABV:5.00 %	name:Stadin American Red Ale; factoryStadin Panimo; style:Amber Ale; ABV:4.50 %	different
name:Bulleit Bourbon Barrel Aged G'Knight; factoryOskar Blues Grill & Brew; style:American Amber / Red Ale; ABV:8.70 %	name:Lompoc Bourbon Barrel Aged Old Tavern Rat; factoryLompoc Brewing; style:Barley Wine; ABV:9.70 %	different
name:Big V Amber Ale; factoryFreeWheel Brewing Company; style:American Amber / Red Ale; ABV:4.00 %	name:Big Texan Texas Red Amber Ale; factoryBig Texan Brewery; style:Amber Ale; ABV:4.50 %	different
name:Double Dread Imperial Red Ale; factoryMad River Brewing Company; style:American Amber / Red Ale; ABV:8.60 %	name:Lagunitas Imperial Red Ale; factoryLagunitas Brewing Company &#40; Heineken &#41;; style:American Strong Ale; ABV:7.80 %	different
name:5 Star Amber Ale; factoryThe Civil Life Brewing Company; style:American Amber / Red Ale; ABV:5.00 %	name:Blue Star Apache Amber Ale; factoryBlue Star Brewing Co. .; style:Amber Ale; ABV:-	different
name:Lavery Imperial Red Ale; factoryLavery Brewing Company; style:American Amber / Red Ale; ABV:8.20 %	name:ShuBrew Heart and Sole Imperial Red Ale; factoryShuBrew; style:American Strong Ale; ABV:6.80 %	different
name:Barrel Aged Imperial Red; factoryHale 's Ales Brewery & Pub; style:American Amber / Red Ale; ABV:9.00 %	name:Imperial Oak Barrel Aged Odin_s Beard; factoryImperial Oak Brewing; style:American Strong Ale; ABV:9 %	different
name:3 Sisters American Red Ale; factoryWild Ride Brewing Co. .; style:American Amber / Red Ale; ABV:6.00 %	name:Black Shirt American India Red Ale; factoryBlack Shirt Brewing Company; style:American Strong Ale; ABV:7.09 %	different
name:Red Dragon Smoked Amber Ale; factoryHoppy Brewing Co. .; style:American Amber / Red Ale; ABV:5.50 %	name:Kilted Dragon Bonnie Heather Amber Ale; factoryKilted Dragon Brewing Company; style:Amber Ale; ABV:5 %	different
name:Mountian Goat Rare Breed India Red Ale; factoryMountain Goat Beer Pty Ltd; style:American Amber / Red Ale; ABV:6.60 %	name:Hammond River Red Coat India Red Ale; factoryHammond River Brewing; style:Amber Ale; ABV:6.50 %	different
name:Lavery Imperial Red Ale; factoryLavery Brewing Company; style:American Amber / Red Ale; ABV:8.20 %	name:Two Brothers Revelry Imperial Red Ale; factoryTwo Brothers Brewing Company; style:American Strong Ale; ABV:9.50 %	different
name:Three Beavers Imperial Red Ale; factoryHowe Sound Inn & Brewing Company; style:American Amber / Red Ale; ABV:7.50 %	name:Renegade Scarlett Letter Imperial Red Ale; factoryRenegade Brewing Company; style:American Strong Ale; ABV:8.50 %	different
name:Red-oric - Beer Camp # 65 ( Best Of Beer Camp : Imperial Red Ale ); factorySierra Nevada Brewing Co. .; style:American Amber / Red Ale; ABV:8.00 %	name:Peter Bs Sum Of Hours Imperial Red Ale; factoryPeter Bs Brewpub; style:American Strong Ale; ABV:9.50 %	different
name:Belle Gueule Rousse; factoryBrasseurs R.J.; style:American Amber / Red Ale; ABV:5.20 %	name:Belle Gueule Rousse; factoryBrasseurs RJ; style:Amber Lager/Vienna; ABV:5.20 %	consistent
name:Red Rock Amber Ale; factoryOPA-OPA Steakhouse & Brewery; style:American Amber / Red Ale; ABV:6.00 %	name:Slanted Rock Iron Butt Red Ale; factorySlanted Rock Brewing Company; style:Amber Ale; ABV:5.80 %	different
name:Ise Kadoya Amber Ale; factoryNikenjayamochi Kadoya Honten Co. / Ise Kadoya Brewery; style:American Amber / Red Ale; ABV:4.50 %	name:Ise Kadoya Amarillo Amber Ale; factoryIse Kadoya; style:Amber Ale; ABV:-	consistent
name:Hop Around Imperial Red Ale; factoryBig Bay Brewing Co. .; style:American Amber / Red Ale; ABV:9.00 %	name:Speakeasy Wet Hop Prohibition Red Ale; factorySpeakeasy Ales and Lagers; style:Amber Ale; ABV:6.10 %	different
name:Deranger Imperial Red Ale; factoryLaurelwood Public House & Brewery; style:American Amber / Red Ale; ABV:8.60 %	name:406 Imperial Red Ale; factory406 Brewing Company; style:American Strong Ale; ABV:9.20 %	different
name:C N Red Imperial Red Ale; factoryRedwood Lodge; style:American Amber / Red Ale; ABV:8.10 %	name:Tumbledown Imp Imperial Red Ale; factoryTumbledown Brewing LLC; style:American Strong Ale; ABV:7.80 %	different
name:All American Red Ale; factoryCentennial Beer Co. .; style:American Amber / Red Ale; ABV:5.00 %	name:Saimaan Brewer_s Special American Red Ale; factorySaimaan Juomatehdas; style:Amber Ale; ABV:4.70 %	different
name:Molly American Red Ale; factoryNew Helvetia Brewing Company; style:American Amber / Red Ale; ABV:5.00 %	name:Big Time Lift Ticket American Red Ale; factoryBig Time Brewery; style:India Pale Ale &#40; IPA &#41;; ABV:7 %	different
name:Barbarian Red Ale; factoryCervecerÃƒa Barbarian; style:American Amber / Red Ale; ABV:6.50 %	name:Barbarian Red Ale; factoryCervecerÃƒa Barbarian; style:Amber Ale; ABV:6.50 %	consistent
name:Hop Around Imperial Red Ale; factoryBig Bay Brewing Co. .; style:American Amber / Red Ale; ABV:9.00 %	name:Ale Mania Imperial Red Ale; factoryAle Mania &#40; Fritz Ale &#41;; style:American Strong Ale; ABV:9.50 %	different
name:Barrel Aged Series : Barley Wine; factoryParallel 49 Brewing Company; style:American Barleywine; ABV:11.80 %	name:Elevator Barrel Aged Barley Wine; factoryElevator Brewing Company; style:Barley Wine; ABV:-	different
name:West Sixth / Country Boy Country Western ( Volume 3 Imperial Red Ale ); factoryWest Sixth Brewing Company; style:American Amber / Red Ale; ABV:13.00 %	name:Figueroa Mountain / Pizza Port Shark Lips Imperial Red Ale; factoryFigueroa Mountain Brewing; style:American Strong Ale; ABV:8 %	different
name:Roundabout Imperial Red Ale; factoryBonfire Brewing Co. .; style:American Amber / Red Ale; ABV:8.80 %	name:Marble Imperial Red Ale; factoryMarble Brewery; style:American Strong Ale; ABV:9 %	different
name:Shark Attack Double Red Ale; factoryPort Brewing; style:American Amber / Red Ale; ABV:9.00 %	name:Midnight Sun Unite Double Red Hot Ale &#40; 2015 &#41;; factoryMidnight Sun Brewing Company; style:Amber Ale; ABV:7.50 %	different
name:Barrel Aged Riverside Red; factoryIntuition Ale Works; style:American Amber / Red Ale; ABV:7.80 %	name:Blue Pants Big & Tall # 2 : Barrel Aged Belgian Red; factoryBlue Pants Brewery; style:Amber Ale; ABV:9 %	different
name:Oatmeal Amber Ale; factoryOrnery Beer Company Public House; style:American Amber / Red Ale; ABV:5.70 %	name:John Harvards Oatmeal Amber Ale; factoryJohn Harvard_s Brewhouse &#40; Corporate Office &#41;; style:Amber Ale; ABV:6.50 %	consistent
name:Buffalo Trace Bourbon Barrel Aged Amber Ale; factoryWolf Hills Brewing Company; style:American Amber / Red Ale; ABV:-	name:Barley_s Barrel Aged Ulysses Imperial Red Ale; factoryBarley_s Brewing Company; style:American Strong Ale; ABV:8.60 %	different
name:Merry Prankster Imperial Red Ale; factoryRock Bottom Restaurant & Brewery; style:American Amber / Red Ale; ABV:4.56 %	name:Marble Imperial Red Ale; factoryMarble Brewery; style:American Strong Ale; ABV:9 %	different
name:Mountain Series : Love Rhino ( Imperial Red Ale ); factoryBreckenridge Brewery; style:American Amber / Red Ale; ABV:8.90 %	name:Two Brothers Revelry Imperial Red Ale; factoryTwo Brothers Brewing Company; style:American Strong Ale; ABV:9.50 %	different
name:Lagunitas Imperial Red Ale; factoryLagunitas Brewing Company; style:American Amber / Red Ale; ABV:7.80 %	name:Sick N Twisted Naughty Redhead Imperial Red Ale; factorySick N Twisted Brewing Company; style:Amber Ale; ABV:8 %	different
name:Imperial Moustache Red Ale; factorySalty Nut Brewery; style:American Amber / Red Ale; ABV:6.00 %	name:Three Heads Buffalo Soul Jah Imperial Red Ale; factoryCustom Brewcrafters; style:American Strong Ale; ABV:9.20 %	different
name:Single Hop # 3 Amber Ale W / Citra; factoryThree Palms Brewing Co. .; style:American Amber / Red Ale; ABV:6.80 %	name:Hill Farmstead Amarillo Single Hop Pale Ale; factoryHill Farmstead Brewery; style:American Pale Ale; ABV:5.20 %	different
name:Vital Infrared Imperial Red; factoryVital Brewing; style:American Amber / Red Ale; ABV:9.40 %	name:Vital Infrared Imperial Red; factoryVital Brewing; style:American Strong Ale; ABV:9.40 %	consistent
name:Rip Saw Red; factoryPints Brewing Co. .; style:American Amber / Red Ale; ABV:6.50 %	name:Pints Rip Saw Red; factoryPints Brewing Company; style:Amber Ale; ABV:5.90 %	consistent
name:Bourbon Barrel Ro Shampo Imperial Red Ale; factoryFigure 8 Brewing; style:American Amber / Red Ale; ABV:-	name:Cape Cod Bourbon Barrel Red; factoryCape Cod Beer; style:Amber Ale; ABV:5.50 %	different
name:Panama Limited Red Ale; factoryFlossmoor Station Restaurant & Brewery; style:American Amber / Red Ale; ABV:-	name:Flossmoor Station Barrel Aged Panama Limited Red Ale; factoryFlossmoor Station Restaurant & Brewery; style:Amber Ale; ABV:6.50 %	different
name:Tst Brw 01 - Imperial Red Ale; factoryBrouwerij De Koninck NV; style:American Amber / Red Ale; ABV:7.80 %	name:Kern River Dirty Hippie Imperial Red Ale; factoryKern River Brewing; style:American Strong Ale; ABV:8 %	different
name:Buffalo Soul Jah Imperial Red Ale; factoryThree Heads Brewing; style:American Amber / Red Ale; ABV:9.20 %	name:Iron Horse Fresh Hop Imperial Red Ale; factoryIron Horse Brewery; style:American Strong Ale; ABV:-	different
name:Roundabout Imperial Red Ale; factoryBonfire Brewing Co. .; style:American Amber / Red Ale; ABV:8.80 %	name:Peter Bs Sum Of Hours Imperial Red Ale; factoryPeter Bs Brewpub; style:American Strong Ale; ABV:9.50 %	different
name:Deputation Imperial Red Ale; factoryBrannon 's Pub and Brewery; style:American Amber / Red Ale; ABV:8.00 %	name:Spring House Atomic Raygun Imperial Red Ale; factorySpring House Brewing Company; style:American Strong Ale; ABV:8.30 %	different
name:American Red Ale; factoryRock Art Brewery; style:American Amber / Red Ale; ABV:4.80 %	name:Americas American Red Ale; factoryAmericas Brewpub; style:Amber Ale; ABV:-	consistent
name:Roundabout Imperial Red Ale; factoryBonfire Brewing Co. .; style:American Amber / Red Ale; ABV:8.80 %	name:Tumbledown Imp Imperial Red Ale; factoryTumbledown Brewing LLC; style:American Strong Ale; ABV:7.80 %	different
name:Double Red Ale; factoryThe Seven Barrel Brewery; style:American Amber / Red Ale; ABV:8.20 %	name:Midnight Sun Unite Double Red Hot Ale &#40; 2015 &#41;; factoryMidnight Sun Brewing Company; style:Amber Ale; ABV:7.50 %	different
name:Molly American Red Ale; factoryNew Helvetia Brewing Company; style:American Amber / Red Ale; ABV:5.00 %	name:Genesee Brew House American Red Ale; factoryGenesee Brewing Company &#40; North American Breweries &#41;; style:Amber Ale; ABV:5 %	different
name:Big Bully Amber Ale; factoryEdge Brewing; style:American Amber / Red Ale; ABV:5.00 %	name:Big Time Atlas Amber Ale; factoryBig Time Brewery; style:Amber Ale; ABV:5.40 %	different
name:Tongue Buckler - Imperial Red Ale; factoryBallast Point Brewing Company; style:American Amber / Red Ale; ABV:10.00 %	name:ShuBrew Heart and Sole Imperial Red Ale; factoryShuBrew; style:American Strong Ale; ABV:6.80 %	different
name:Bourbon Barrel Ro Shampo Imperial Red Ale; factoryFigure 8 Brewing; style:American Amber / Red Ale; ABV:-	name:Lavery Imperial Red Ale &#40; IRA &#41;; factoryLavery Brewing Company; style:American Strong Ale; ABV:8.20 %	different
name:Sequoia American Amber Ale; factoryWig And Pen; style:American Amber / Red Ale; ABV:5.90 %	name:Aarhus Cains Triple A American Amber Ale; factoryAarhus Bryghus; style:Amber Ale; ABV:5.50 %	different
name:Broadhead Bourbon Barrel Aged Red; factoryBainbridge Island Brewing Company; style:American Amber / Red Ale; ABV:8.50 %	name:MadTree Bourbon Barrel Aged Happy Amber; factoryMadTree Brewing Company; style:Amber Ale; ABV:6 %	different
name:Sledgehammer Imperial Red Ale; factoryCambridge Brewing Company; style:American Amber / Red Ale; ABV:7.75 %	name:Anacapa Riptide Imperial Red Ale; factoryAnacapa Brewing Company; style:American Strong Ale; ABV:8 %	different
name:Old Guardian Barley Wine Style Ale - Red Wine Barrel Aged; factoryStone Brewing Co. .; style:American Barleywine; ABV:11.20 %	name:Fulton The Libertine Imperial Red Ale - Heaven Hill Rye Whiskey Barrel Aged; factoryFulton Beer Company; style:American Strong Ale; ABV:8.50 %	different
name:Mountain Series : Love Rhino ( Imperial Red Ale ); factoryBreckenridge Brewery; style:American Amber / Red Ale; ABV:8.90 %	name:Tumbledown Imp Imperial Red Ale; factoryTumbledown Brewing LLC; style:American Strong Ale; ABV:7.80 %	different
name:Mad Anthony Muddy River Amber Ale; factoryMad Anthony Brewing Company; style:American Amber / Red Ale; ABV:-	name:Mad River Jamaica Red Ale; factoryMad River Brewery; style:Amber Ale; ABV:6.50 %	different
name:Simeon Jones River Valley Amber Ale; factoryPicaroons Brewing Co. .; style:American Amber / Red Ale; ABV:4.50 %	name:Piney River McKinney Eddy Amber Ale; factoryPiney River Brewing Company; style:Amber Ale; ABV:-	different
name:Deranger Imperial Red Ale; factoryLaurelwood Public House & Brewery; style:American Amber / Red Ale; ABV:8.60 %	name:Kinetic Infrared Imperial Red Ale; factoryKinetic Brewing Company; style:American Strong Ale; ABV:9.30 %	different
name:Red Rocket Amber Ale; factoryThird Base Sports Bar & Brewery; style:American Amber / Red Ale; ABV:6.40 %	name:Red Duck Amber Ale; factoryPurrumbete Brewing; style:Amber Ale; ABV:4.80 %	different
name:Double Red Hot Ale; factoryMidnight Sun Brewing Co. .; style:American Amber / Red Ale; ABV:7.57 %	name:Destihl Barrel Aged Deadhead Double Red Ale; factoryDestihl Brewery; style:American Strong Ale; ABV:-	different
name:Wasatch 50th Park City Golden Anniversary Ale; factoryUtah Brewers Cooperative; style:American Amber / Red Ale; ABV:4.00 %	name:Golden City Centurion Barleywine Ale; factoryGolden City Brewery; style:Barley Wine; ABV:11.20 %	different
name:Regimental 80 Scottish Ale; factoryCrooked Eye Brewery; style:American Amber / Red Ale; ABV:4.70 %	name:Crooked Eye Regimental 80 Scottish Ale; factoryCrooked Eye Brewery; style:Scottish Ale; ABV:4.70 %	consistent
name:Dream Of The 90 's; factoryProhibition Pig; style:American Amber / Red Ale; ABV:6.10 %	name:Prohibition Pig Dream of the 90s; factoryProhibition Pig; style:Amber Ale; ABV:-	consistent
name:Fullers Traitors ' Gate; factoryFuller Smith & Turner PLC; style:American Amber / Red Ale; ABV:4.50 %	name:Fuller_s Traitor_s Gate; factoryFuller_s; style:Bitter; ABV:4.50 %	consistent
name:Sledgehammer Imperial Red Ale; factoryCambridge Brewing Company; style:American Amber / Red Ale; ABV:7.75 %	name:Edge Imperial Red Ale &#40; Spring Seasonal &#41;; factoryEdge Brewing Company; style:American Strong Ale; ABV:8.50 %	different
name:Weekender American Amber Ale; factoryStilt House Brewery; style:American Amber / Red Ale; ABV:5.20 %	name:Canal Park General Sterling Price American Amber Ale - Centennial; factoryCanal Park Brewing Company; style:Amber Ale; ABV:4.80 %	different
name:Blarney Rock Irish Ale; factoryRockyard Brewing; style:American Amber / Red Ale; ABV:6.00 %	name:Rockyard Blarney Rock Irish Ale; factoryRockyard Brewing Company; style:Irish Ale; ABV:-	consistent
name:Aiken American Red Pale Ale; factoryAiken Brewing Company; style:American Amber / Red Ale; ABV:-	name:Blue Heron Corey_s American Pale Ale &#40; C.A.P.A. &#41;; factoryBlue Heron Brewpub; style:American Pale Ale; ABV:6.20 %	different
name:Deranger Imperial Red Ale; factoryLaurelwood Public House & Brewery; style:American Amber / Red Ale; ABV:8.60 %	name:Ale Mania Imperial Red Ale; factoryAle Mania &#40; Fritz Ale &#41;; style:American Strong Ale; ABV:9.50 %	different
name:Big Bear Amber Ale; factoryStewart 's Brewing Co. .; style:American Amber / Red Ale; ABV:5.60 %	name:Big Horn Buttface Amber Ale; factoryBig Horn Brewing Company &#40; Ram International &#41;; style:Amber Ale; ABV:5.80 %	different
name:Great Lakes Independence Ale; factoryGreat Lakes Brewing Co. .; style:American Amber / Red Ale; ABV:6.00 %	name:Amsterdam X Sawdust City X Great Lakes X Indie Ale Barley Wine &#40; Oak &#41;; factoryAmsterdam Brewing Company; style:Barley Wine; ABV:10 %	different
name:Three Beavers Imperial Red Ale; factoryHowe Sound Inn & Brewing Company; style:American Amber / Red Ale; ABV:7.50 %	name:Scuttlebutt Mateo Loco Imperial Red Ale; factoryScuttlebutt Brewing Co. .; style:American Strong Ale; ABV:7.10 %	different
name:Hop Around Imperial Red Ale; factoryBig Bay Brewing Co. .; style:American Amber / Red Ale; ABV:9.00 %	name:Laguna Beach Grateful Red Imperial Red Ale; factoryLaguna Beach Brewing; style:American Strong Ale; ABV:11 %	different
name:Ale Mania Imperial Red Ale; factoryAle-Mania; style:American Amber / Red Ale; ABV:9.50 %	name:Tumbledown Imp Imperial Red Ale; factoryTumbledown Brewing LLC; style:American Strong Ale; ABV:7.80 %	different
name:Mountain Series : Love Rhino ( Imperial Red Ale ); factoryBreckenridge Brewery; style:American Amber / Red Ale; ABV:8.90 %	name:Cigar City Cold Brew Series - Red Ale; factoryCigar City Brewing; style:Amber Ale; ABV:7.20 %	different
name:Shirt Tail Amber; factoryIron Hill Brewery & Restaurant; style:American Amber / Red Ale; ABV:4.40 %	name:Iron Hill Shirt Tail Amber; factoryIron Hill Maple Shade; style:Amber Ale; ABV:4.40 %	consistent
name:Desert Island Series : American Honey Amber Ale; factoryHeavy Seas Beer; style:American Amber / Red Ale; ABV:4.90 %	name:Granville Island Gastown Amber Ale; factoryGranville Island &#40; Brewery - MolsonCoors &#41;; style:Amber Ale; ABV:5.50 %	different
name:Starlord 's Mixtape / Groot Drank Imperial Red Ale; factoryCharging Hippo Brewing Co. .; style:American Amber / Red Ale; ABV:8.20 %	name:Pizza Port Rhino Chaser Imperial Red Ale; factoryPizza Port &#40; Ocean Beach &#41;; style:American Strong Ale; ABV:9.50 %	different
name:Barrel Aged Red Ale; factoryBearWaters Brewing Co. .; style:American Amber / Red Ale; ABV:6.70 %	name:Barley_s Barrel Aged Ulysses Imperial Red Ale; factoryBarley_s Brewing Company; style:American Strong Ale; ABV:8.60 %	different
name:Stupiphany Imperial Red Ale; factoryRusty Truck Brewing Company / Roadhouse 101; style:American Amber / Red Ale; ABV:8.00 %	name:Sick N Twisted Naughty Redhead Imperial Red Ale; factorySick N Twisted Brewing Company; style:Amber Ale; ABV:8 %	different
name:Red 88 Imperial Amber Ale; factoryRiver City Brewing Co. .; style:American Amber / Red Ale; ABV:8.00 %	name:Yukon You Only Live Once Imperial Red Ale; factoryYukon Brewing Company; style:Amber Ale; ABV:7.50 %	different
name:Hurricane Alley Amber Ale; factoryFlorida Beer Company; style:American Amber / Red Ale; ABV:-	name:Charleville Tornado Alley Amber Ale; factoryCharleville Vineyard & Microbrewery; style:Amber Ale; ABV:-	different
name:Mountain Series : Love Rhino ( Imperial Red Ale ); factoryBreckenridge Brewery; style:American Amber / Red Ale; ABV:8.90 %	name:Kinetic Infrared Imperial Red Ale; factoryKinetic Brewing Company; style:American Strong Ale; ABV:9.30 %	different
name:Brewmaster 's Reserve Imperial Red Ale; factoryBJ 's Chicago Pizza & Brewery Inc. .; style:American Amber / Red Ale; ABV:9.20 %	name:Rock Bottom Orland Park King of Hearts Imperial Red Ale; factoryRock Bottom Orland Park; style:American Strong Ale; ABV:7.60 %	different
name:Red Headed Slut Amber Ale; factoryTwisted K-8 Brewing Company; style:American Amber / Red Ale; ABV:6.50 %	name:Baird Red Rose Amber Ale; factoryBaird Brewing Co. .; style:California Common; ABV:5.40 %	different
name:Bulleit Bourbon Barrel Aged G'Knight; factoryOskar Blues Grill & Brew; style:American Amber / Red Ale; ABV:8.70 %	name:MadTree Bourbon Barrel Aged Happy Amber; factoryMadTree Brewing Company; style:Amber Ale; ABV:6 %	different
name:Aiken American Red Pale Ale; factoryAiken Brewing Company; style:American Amber / Red Ale; ABV:-	name:Wild Ride 3 Sisters American Red Ale; factoryWild Ride Brewing; style:Amber Ale; ABV:6 %	different
name:Phobos Single Hop Red Ale; factoryEcliptic Brewing; style:American Amber / Red Ale; ABV:7.40 %	name:Iron Horse Fresh Hop Imperial Red Ale; factoryIron Horse Brewery; style:American Strong Ale; ABV:-	different
name:Frost Quake Bourbon Barrel Aged Barley Wine; factoryWellington County Brewery; style:American Barleywine; ABV:9.80 %	name:MadTree Bourbon Barrel Aged Happy Amber; factoryMadTree Brewing Company; style:Amber Ale; ABV:6 %	different
name:Bourbon Barrel Aged Horus Imperial Red; factoryElevator Brewery & Draught Haus; style:American Amber / Red Ale; ABV:12.00 %	name:Legacy Bourbon Barrel Hedonism Red; factoryLegacy Brewing; style:American Strong Ale; ABV:7.10 %	different
name:Rocky Mountain Red Ale; factoryGrand Lake Brewing Company; style:American Amber / Red Ale; ABV:-	name:Crazy Mountain Boohai Red Ale &#40; Kura Koa &#41;; factoryCrazy Mountain Brewing Company; style:Amber Ale; ABV:6 %	different
name:Ro Shampo Imperial Red Ale; factoryFigure 8 Brewing; style:American Amber / Red Ale; ABV:7.50 %	name:Kern River Dirty Hippie Imperial Red Ale; factoryKern River Brewing; style:American Strong Ale; ABV:8 %	different
name:Red-oric - Beer Camp # 65 ( Best Of Beer Camp : Imperial Red Ale ); factorySierra Nevada Brewing Co. .; style:American Amber / Red Ale; ABV:8.00 %	name:Rock Bottom Orland Park King of Hearts Imperial Red Ale; factoryRock Bottom Orland Park; style:American Strong Ale; ABV:7.60 %	different
name:Alaskan Barley Wine ( Pilot Series ); factoryAlaskan Brewing Co. .; style:American Barleywine; ABV:10.70 %	name:Hermit Thrush Abbey Series # 1 - Jolly Abbot Barley Wine; factoryHermit Thrush Brewery; style:Barley Wine; ABV:13 %	different
name:Starfish Imperial Red Ale; factoryFish Brewing Company / Fishbowl Brewpub; style:American Amber / Red Ale; ABV:7.50 %	name:Worthy Eruption Imperial Red Ale; factoryWorthy Brewing Company; style:American Strong Ale; ABV:8 %	different
name:3 Sisters American Red Ale; factoryWild Ride Brewing Co. .; style:American Amber / Red Ale; ABV:6.00 %	name:Stadin American Red Ale; factoryStadin Panimo; style:Amber Ale; ABV:4.50 %	different
name:Double Mongrel Imperial India Red Ale; factoryAspetuck Brew Lab; style:American Amber / Red Ale; ABV:9.00 %	name:Peter Bs Sum Of Hours Imperial Red Ale; factoryPeter Bs Brewpub; style:American Strong Ale; ABV:9.50 %	different
name:Buffalo Soul Jah Imperial Red Ale; factoryThree Heads Brewing; style:American Amber / Red Ale; ABV:9.20 %	name:Fulton The Libertine Imperial Red Ale - Heaven Hill Rye Whiskey Barrel Aged; factoryFulton Beer Company; style:American Strong Ale; ABV:8.50 %	different
name:Fisherman 's Tea Party; factoryCape Ann Brewing Company; style:American Barleywine; ABV:9.00 %	name:Cape Ann Fisherman_s Tea Party; factoryCape Ann Brewing Company; style:Barley Wine; ABV:9 %	consistent
name:Red-oric - Beer Camp # 65 ( Best Of Beer Camp : Imperial Red Ale ); factorySierra Nevada Brewing Co. .; style:American Amber / Red Ale; ABV:8.00 %	name:Two Brothers Revelry Imperial Red Ale; factoryTwo Brothers Brewing Company; style:American Strong Ale; ABV:9.50 %	different
name:6th Anniversary Ale ( Dirty Hippie Imperial Red Ale ); factoryKern River Brewing Company; style:American Amber / Red Ale; ABV:8.00 %	name:Two Brothers Revelry Imperial Red Ale; factoryTwo Brothers Brewing Company; style:American Strong Ale; ABV:9.50 %	different
name:Kingpin Double Red Ale; factoryBridgePort Brewing Co. / Brewpub; style:American Amber / Red Ale; ABV:7.50 %	name:Out of Bounds Relentless Double Red Ale; factoryOut of Bounds Brewing Company; style:American Strong Ale; ABV:8.20 %	different
name:Ale Mania Imperial Red Ale; factoryAle-Mania; style:American Amber / Red Ale; ABV:9.50 %	name:Proof Abandoned Planet Imperial Red Ale; factoryProof Brewing Company; style:Amber Ale; ABV:7.50 %	different
name:Aorta Ale ( Double Red Ale ); factoryShort 's Brewing Company; style:American Amber / Red Ale; ABV:8.30 %	name:Wildcard Double Down Imperial Red Ale; factoryWildcard Brewing Company; style:American Strong Ale; ABV:7.50 %	different
name:Ulysses Imperial Red Ale; factoryBarley 's Brewing Company; style:American Amber / Red Ale; ABV:-	name:Ballast Point Tongue Buckler Imperial Red Ale - Bourbon Barrel Aged; factoryBallast Point Brewing Company; style:American Strong Ale; ABV:10 %	different
name:Harold The Red Ale; factoryBlack Husky Brewing; style:American Amber / Red Ale; ABV:-	name:Off the Rail Raybuck Red Ale; factoryOff the Rail Brewing; style:Amber Ale; ABV:6.40 %	different
name:Double Dread Imperial Red Ale; factoryMad River Brewing Company; style:American Amber / Red Ale; ABV:8.60 %	name:Ballast Point Tongue Buckler Imperial Red Ale - Bourbon Barrel Aged; factoryBallast Point Brewing Company; style:American Strong Ale; ABV:10 %	different
name:Insane Mane Red Ale; factoryWhite Lion Brewing Company; style:American Amber / Red Ale; ABV:5.10 %	name:White Lion Insane Mane Red Ale; factoryIpswich Ale Brewery; style:Amber Ale; ABV:-	consistent
name:Eruption Imperial Red Ale; factoryWorthy Brewing Co. .; style:American Amber / Red Ale; ABV:8.00 %	name:Ale Mania Imperial Red Ale; factoryAle Mania &#40; Fritz Ale &#41;; style:American Strong Ale; ABV:9.50 %	different
name:Deranger Imperial Red Ale; factoryLaurelwood Public House & Brewery; style:American Amber / Red Ale; ABV:8.60 %	name:Brannon_s Deputation Imperial Red Ale; factoryBrannon_s Pub and Brewery; style:American Strong Ale; ABV:8.79 %	different
name:Sequoia American Amber Ale; factoryWig And Pen; style:American Amber / Red Ale; ABV:5.90 %	name:Canal Park General Sterling Price American Amber Ale - Centennial; factoryCanal Park Brewing Company; style:Amber Ale; ABV:4.80 %	different
name:Frost Quake Bourbon Barrel Aged Barley Wine; factoryWellington County Brewery; style:American Barleywine; ABV:9.80 %	name:Hangar 24 Barrel Roll No. 04 : Hammerhead - Bourbon Barrel Aged with Chai Tea; factoryHangar 24 Craft Brewery; style:Barley Wine; ABV:13.90 %	different
name:Road Rash Red; factoryTandem Brewing Company; style:American Amber / Red Ale; ABV:6.00 %	name:Kettle House Bourbon Barrel Road Rash Imperial Red Ale; factoryKettle House Brewing Company; style:American Strong Ale; ABV:13 %	different
name:Willoughby American Amber Ale; factoryWilloughby Brewing; style:American Amber / Red Ale; ABV:4.90 %	name:Maldita Old Continent American Amber Ale; factoryFaustino Microcervejeira; style:Amber Ale; ABV:6 %	different
name:Old Guardian Barley Wine Style Ale - Bourbon Barrel Aged; factoryStone Brewing Co. .; style:American Barleywine; ABV:11.20 %	name:Revolution Barrel Aged Institutionalized Barley Wine; factoryRevolution Brewing Company; style:Barley Wine; ABV:13 %	different
name:Red Headed Slut Amber Ale; factoryTwisted K-8 Brewing Company; style:American Amber / Red Ale; ABV:6.50 %	name:Trailhead Red Amber Ale; factoryTrailhead Brewing Co. .; style:Amber Ale; ABV:-	different
name:Red Hopper ( Imperial Red Ale ); factoryBlack Acre Brewing Co. .; style:American Amber / Red Ale; ABV:6.20 %	name:Worthy Eruption Imperial Red Ale; factoryWorthy Brewing Company; style:American Strong Ale; ABV:8 %	different
name:Ro Shampo Imperial Red Ale; factoryFigure 8 Brewing; style:American Amber / Red Ale; ABV:7.50 %	name:Ballast Point Tongue Buckler Imperial Red Ale - Bourbon Barrel Aged; factoryBallast Point Brewing Company; style:American Strong Ale; ABV:10 %	different
name:BJ 's Imperial Red Ale; factoryBJ 's Restaurant & Brewhouse; style:American Amber / Red Ale; ABV:9.00 %	name:Fulton The Libertine Imperial Red Ale - Heaven Hill Rye Whiskey Barrel Aged; factoryFulton Beer Company; style:American Strong Ale; ABV:8.50 %	different
name:Three Beavers Imperial Red Ale; factoryHowe Sound Inn & Brewing Company; style:American Amber / Red Ale; ABV:7.50 %	name:Mission Carrack Imperial Red Ale; factoryMission Brewery; style:American Strong Ale; ABV:10.20 %	different
name:Kniksen India Red Ale; factory7 Fjell Bryggeri; style:American Amber / Red Ale; ABV:6.80 %	name:Good People Stepchild Belgian India Red Ale; factoryGood People Brewing Company; style:India Pale Ale &#40; IPA &#41;; ABV:7.80 %	different
name:Pioneer American Red Ale; factoryPioneer Beer Company; style:American Amber / Red Ale; ABV:5.70 %	name:Fat Bottom Ruby Red American Ale; factoryFat Bottom Brewery; style:Amber Ale; ABV:4.60 %	different
name:Clifford The Big Red Ale; factoryBooks & Brews; style:American Amber / Red Ale; ABV:6.80 %	name:Big Choice Disconnected Red Ale; factoryBig Choice Brewing; style:Amber Ale; ABV:6.70 %	different
name:Boohai Red Ale; factoryCrazy Mountain Brewing Company; style:American Amber / Red Ale; ABV:6.00 %	name:Crazy Mountain Boohai Red Ale &#40; Kura Koa &#41;; factoryCrazy Mountain Brewing Company; style:Amber Ale; ABV:6 %	consistent
name:Barrel Aged Chessie; factoryUnion Craft Brewing Company; style:American Barleywine; ABV:9.80 %	name:Union Craft Chessie Barleywine Barrel Aged; factoryUnion Craft Brewing Company; style:Barley Wine; ABV:9.80 %	consistent
name:Trail Ridge Red; factoryGrand Lake Brewing Company; style:American Amber / Red Ale; ABV:7.50 %	name:Estes Park Trail Ridge Red; factoryEstes Park Brewery; style:Bitter; ABV:4.50 %	consistent
name:Brewmaster 's Reserve Imperial Red Ale; factoryBJ 's Chicago Pizza & Brewery Inc. .; style:American Amber / Red Ale; ABV:9.20 %	name:Renegade Scarlett Letter Imperial Red Ale; factoryRenegade Brewing Company; style:American Strong Ale; ABV:8.50 %	different
name:Red Dragon Imperial Red Ale; factoryDead Frog Brewing; style:American Amber / Red Ale; ABV:8.00 %	name:Proof Abandoned Planet Imperial Red Ale; factoryProof Brewing Company; style:Amber Ale; ABV:7.50 %	different
name:3 Sisters American Red Ale; factoryWild Ride Brewing Co. .; style:American Amber / Red Ale; ABV:6.00 %	name:Radiant Pig Gangster Duck American Red Ale; factoryRadiant Pig Beer Company; style:Amber Ale; ABV:6.20 %	different
name:Alaskan Imperial Red Ale ( Pilot Series ); factoryAlaskan Brewing Co. .; style:American Amber / Red Ale; ABV:8.50 %	name:Swamp Head Sciaenhops Imperial Red Ale; factorySwamp Head Brewery; style:American Strong Ale; ABV:8.30 %	different
name:Summer Session Ale; factoryElk Creek Cafe + Aleworks; style:American Amber / Red Ale; ABV:4.20 %	name:Aqula Summer Session Ale; factoryAqula; style:English Pale Ale; ABV:4.50 %	consistent
name:Stupiphany Imperial Red Ale; factoryRusty Truck Brewing Company / Roadhouse 101; style:American Amber / Red Ale; ABV:8.00 %	name:AleSmith YuleSmith &#40; Winter &#41; Imperial Red Ale; factoryAleSmith Brewing Company; style:American Strong Ale; ABV:8.50 %	different
name:Jurassic Duck Amber Ale ( dry Hopped With Mosaic ); factoryThe Dodging Duck Brewhaus; style:American Amber / Red Ale; ABV:-	name:Nighthawk 16-Hour Dry Hopped Amber; factoryNighthawk Brewery; style:Amber Ale; ABV:6.70 %	different
name:Photobomb Imperial Red Ale; factoryCrooked Ladder Brewing Company; style:American Amber / Red Ale; ABV:8.50 %	name:Howe Sound Three Beavers Imperial Red Ale; factoryHowe Sound Brewing; style:American Strong Ale; ABV:7.50 %	different
name:O'Connor 's Irish Red Ale; factoryWormtown Brewery; style:American Amber / Red Ale; ABV:5.00 %	name:Loose Shoe SlÃƒ Â¡ inte Irish Red Ale; factoryLoose Shoe Brewing Company; style:Irish Ale; ABV:5.50 %	different
name:Winter Seasonal Amber Ale; factoryDead Frog Brewing; style:American Amber / Red Ale; ABV:5.00 %	name:Brewsters Winter WARMer Amber Ale; factoryBrewsters Brewing Co. - Alberta; style:Amber Ale; ABV:6 %	different
name:Hawai'i Nui Sunset Amber Ale; factoryHawai'i Nui Brewing / Mehana Brewing Company; style:American Amber / Red Ale; ABV:5.45 %	name:Grand Canyon Sunset Amber Ale; factoryGrand Canyon Brewing Company; style:Amber Ale; ABV:5 %	different
name:Street Cred India Rye Red Ale; factoryRoaring Fork Beer Company; style:American Amber / Red Ale; ABV:7.20 %	name:Good People Stepchild Belgian India Red Ale; factoryGood People Brewing Company; style:India Pale Ale &#40; IPA &#41;; ABV:7.80 %	different
name:Double Mongrel Imperial India Red Ale; factoryAspetuck Brew Lab; style:American Amber / Red Ale; ABV:9.00 %	name:Spring House Atomic Raygun Imperial Red Ale; factorySpring House Brewing Company; style:American Strong Ale; ABV:8.30 %	different
name:Red Shedman 's Imperial Amber Ale; factory57 Brew Pub & Bistro; style:American Amber / Red Ale; ABV:7.60 %	name:Kinetic Infrared Imperial Red Ale; factoryKinetic Brewing Company; style:American Strong Ale; ABV:9.30 %	different
name:Eruption Imperial Red Ale; factoryWorthy Brewing Co. .; style:American Amber / Red Ale; ABV:8.00 %	name:De Koninck TSTBRW 01 Imperial Red Ale; factoryBrouwerij De Koninck &#40; Duvel-Moortgat &#41;; style:American Strong Ale; ABV:7.80 %	different
name:Copperhead Amber Ale; factoryYalobusha Brewing Company; style:American Amber / Red Ale; ABV:5.65 %	name:Yalobusha Copperhead Amber Ale; factoryYalobusha Brewing Company; style:Amber Ale; ABV:5.60 %	consistent
name:Dark Horse Amber Ale; factoryDark Horse Brewing Company; style:American Amber / Red Ale; ABV:5.50 %	name:Dark Horse Amber Ale; factoryDark Horse Brewing Company; style:Amber Ale; ABV:5.50 %	consistent
name:Starlord 's Mixtape / Groot Drank Imperial Red Ale; factoryCharging Hippo Brewing Co. .; style:American Amber / Red Ale; ABV:8.20 %	name:Iron Horse Fresh Hop Imperial Red Ale; factoryIron Horse Brewery; style:American Strong Ale; ABV:-	different
name:Red Emperor Amber Ale; factoryFish Rock Brewery; style:American Amber / Red Ale; ABV:4.50 %	name:Fox and Hound Red Fox Amber Ale; factoryAnheuser-Busch InBev; style:Amber Ale; ABV:5.10 %	different
name:Double Mongrel Imperial India Red Ale; factoryAspetuck Brew Lab; style:American Amber / Red Ale; ABV:9.00 %	name:Boxing Cat Firecracker Imperial Red Ale; factoryBoxing Cat Brewery; style:Amber Ale; ABV:6.60 %	different
name:Strada S. Felice; factoryGrado Plato; style:American Amber / Red Ale; ABV:8.00 %	name:Grado Plato Strada S. Felice; factoryBirrificio Grado Plato; style:Spice/Herb/Vegetable; ABV:8 %	consistent
name:Morrisons American Red Ale; factoryTitanic Brewery; style:American Amber / Red Ale; ABV:4.50 %	name:Americas American Red Ale; factoryAmericas Brewpub; style:Amber Ale; ABV:-	different
name:Arsenal Imperial Red Ale; factoryGreat River Brewery; style:American Amber / Red Ale; ABV:9.00 %	name:Kern River Dirty Hippie Imperial Red Ale; factoryKern River Brewing; style:American Strong Ale; ABV:8 %	different
name:Sea Spray Amber Ale; factoryBowen Island Brewing Co. Ltd. .; style:American Amber / Red Ale; ABV:5.00 %	name:Swashbuckler Red Sea Amber Ale; factorySwashbuckler Brewing Company; style:Amber Ale; ABV:-	different
name:Alaskan Imperial Red Ale ( Pilot Series ); factoryAlaskan Brewing Co. .; style:American Amber / Red Ale; ABV:8.50 %	name:BottleTree Imperial Red Ale; factoryThomas Creek Brewery; style:American Strong Ale; ABV:7.50 %	different
name:Double Dread Imperial Red Ale; factoryMad River Brewing Company; style:American Amber / Red Ale; ABV:8.60 %	name:Ballast Point Tongue Buckler Imperial Red Ale; factoryBallast Point Brewing Company; style:American Strong Ale; ABV:10 %	different
name:Big V Amber Ale; factoryFreeWheel Brewing Company; style:American Amber / Red Ale; ABV:4.00 %	name:Heinzelmannchen Big Amber Gnome Ale; factoryHeinzelmannchen Brewery; style:Amber Ale; ABV:8 %	different
name:Big Horn Buttface Amber Ale; factoryC.B. & Potts; style:American Amber / Red Ale; ABV:-	name:Big Texan Texas Red Amber Ale; factoryBig Texan Brewery; style:Amber Ale; ABV:4.50 %	different
name:Smuttynose Kindest Find Imperial Red Ale; factorySmuttynose Brewing Company; style:American Amber / Red Ale; ABV:8.50 %	name:Kettle House Bourbon Barrel Road Rash Imperial Red Ale; factoryKettle House Brewing Company; style:American Strong Ale; ABV:13 %	different
name:Beer Of The Dragon; factoryBeachwood BBQ & Brewing; style:American Amber / Red Ale; ABV:9.10 %	name:Anderson Valley Barrel Aged Horn of the Beer Barley Wine; factoryAnderson Valley Brewing Company; style:Barley Wine; ABV:8.60 %	different
name:Barrel Aged Series : Barley Wine; factoryParallel 49 Brewing Company; style:American Barleywine; ABV:11.80 %	name:Hangar 24 Barrel Roll No. 04 : Hammerhead - Barrel Aged Barley Wine; factoryHangar 24 Craft Brewery; style:Barley Wine; ABV:11.20 %	different
name:Isle Of Pines Barley Wine; factoryFlying Goose Brew Pub & Grille; style:American Barleywine; ABV:11.00 %	name:Anderson Valley Barrel Aged Horn of the Beer Barley Wine; factoryAnderson Valley Brewing Company; style:Barley Wine; ABV:8.60 %	different
name:Noggin Floggin ( Bourbon Barrel Aged ); factoryHopworks Urban Brewery; style:American Barleywine; ABV:9.60 %	name:MadTree Bourbon Barrel Aged Happy Amber; factoryMadTree Brewing Company; style:Amber Ale; ABV:6 %	different
name:Mermaid 's Red Ale - Bourbon Oak Aged; factoryCoronado Brewing Company; style:American Amber / Red Ale; ABV:-	name:Brew Bus Detour Series : Rollin Dirty Red Ale - Wood Aged; factoryCigar City Brewing; style:Irish Ale; ABV:5 %	different
name:Imperial Red Ale; factoryEpic Brewing Company; style:American Amber / Red Ale; ABV:7.70 %	name:ShuBrew Heart and Sole Imperial Red Ale; factoryShuBrew; style:American Strong Ale; ABV:6.80 %	different
name:Frog Island Amber Ale; factoryFrog Island Brewing Company; style:American Amber / Red Ale; ABV:6.00 %	name:Heavy Seas Desert Island Series American Honey Amber Ale; factoryHeavy Seas Brewing Company; style:Amber Ale; ABV:4.90 %	different
name:Olde Richmond Batch No. 9 Red Ale; factoryOlde Richmond Beer Company; style:American Amber / Red Ale; ABV:-	name:Engine House No. 9 Rowdy Dick Amber Ale; factoryEngine House No. 9 Restaurant and Brewery; style:Amber Ale; ABV:5.30 %	different
name:West Sixth / Country Boy Country Western ( Volume 3 Imperial Red Ale ); factoryWest Sixth Brewing Company; style:American Amber / Red Ale; ABV:13.00 %	name:Ballast Point Tongue Buckler Imperial Red Ale; factoryBallast Point Brewing Company; style:American Strong Ale; ABV:10 %	different
name:Double Dragon Imperial Red Ale; factoryPhillips Brewing Company; style:American Amber / Red Ale; ABV:8.20 %	name:Wildcard Double Down Imperial Red Ale; factoryWildcard Brewing Company; style:American Strong Ale; ABV:7.50 %	different
name:Barrel Aged Imperial Red Ale; factoryBoone Valley Brewing; style:American Amber / Red Ale; ABV:9.99 %	name:Laurelwood Organic Deranger Imperial Red Ale; factoryLaurelwood Public House & Brewery; style:American Strong Ale; ABV:8.60 %	different
name:Ruby River Ruby Red Ale; factoryRuby River Steakhouse & Brewery; style:American Amber / Red Ale; ABV:4.00 %	name:Pine Creek River Valley Red Ale; factoryBig Rock Brewery; style:Amber Ale; ABV:5 %	different
name:Buffalo Trace Bourbon Barrel Aged Amber Ale; factoryWolf Hills Brewing Company; style:American Amber / Red Ale; ABV:-	name:Barrel Trolley Amber Ale; factoryGenesee Brewing Company &#40; North American Breweries &#41;; style:Amber Ale; ABV:-	different
name:Bourbon Barrel Aged Auld Bitch; factoryTahoe Mountain Brewing Co. .; style:American Barleywine; ABV:11.00 %	name:Lompoc Bourbon Barrel Aged Proletariat Red Ale; factoryLompoc Brewing; style:Amber Ale; ABV:6.40 %	different
name:Unite Red Rye Ale; factoryThe Pike Brewing Company; style:American Amber / Red Ale; ABV:4.60 %	name:Pike Unite Red Rye Ale; factoryPike Brewing Company; style:Amber Ale; ABV:4.60 %	consistent
name:Red Dirt Imperial Red Ale; factoryWiley Roots Brewing Co; style:American Amber / Red Ale; ABV:8.20 %	name:Laguna Beach Grateful Red Imperial Red Ale; factoryLaguna Beach Brewing; style:American Strong Ale; ABV:11 %	different
name:Lagunitas Imperial Red Ale; factoryLagunitas Brewing Company; style:American Amber / Red Ale; ABV:7.80 %	name:Pizza Port Rhino Chaser Imperial Red Ale; factoryPizza Port &#40; Ocean Beach &#41;; style:American Strong Ale; ABV:9.50 %	different
name:Brewmaster 's Reserve Imperial Red Ale; factoryBJ 's Chicago Pizza & Brewery Inc. .; style:American Amber / Red Ale; ABV:9.20 %	name:Rusty Truck Stupiphany Imperial Red Ale; factoryRusty Truck Brewing / Roadhouse 101; style:American Strong Ale; ABV:8 %	different
name:Rhino Chaser Imperial Red Ale; factoryPizza Port Solana Beach; style:American Amber / Red Ale; ABV:9.50 %	name:Lagunitas Imperial Red Ale; factoryLagunitas Brewing Company &#40; Heineken &#41;; style:American Strong Ale; ABV:7.80 %	different
name:Batch 200 _ `` Olympus Mons Imperial Red Ale; factoryDue South Brewing Co. .; style:American Amber / Red Ale; ABV:9.20 %	name:Edge Imperial Red Ale &#40; Spring Seasonal &#41;; factoryEdge Brewing Company; style:American Strong Ale; ABV:8.50 %	different
name:Red Dirt Imperial Red Ale; factoryWiley Roots Brewing Co; style:American Amber / Red Ale; ABV:8.20 %	name:Ballast Point Tongue Buckler Imperial Red Ale - Bourbon Barrel Aged; factoryBallast Point Brewing Company; style:American Strong Ale; ABV:10 %	different
name:Fresh Hop Red; factoryLiquid Mechanics Brewing Co. .; style:American Amber / Red Ale; ABV:7.40 %	name:Ice Harbor Double Red Ale - Fresh Hop; factoryIce Harbor Brewing Company; style:Amber Ale; ABV:7 %	different
name:Big V Amber Ale; factoryFreeWheel Brewing Company; style:American Amber / Red Ale; ABV:4.00 %	name:Big Axe Maple Wheat Amber Ale; factoryBig Axe Brewery and B & B; style:Amber Ale; ABV:5 %	different
name:Red Rose Amber Ale; factoryBaird Brewing Company / Fishmarket Taproom; style:American Amber / Red Ale; ABV:5.40 %	name:Swashbuckler Red Sea Amber Ale; factorySwashbuckler Brewing Company; style:Amber Ale; ABV:-	different
name:Hop Around Imperial Red Ale; factoryBig Bay Brewing Co. .; style:American Amber / Red Ale; ABV:9.00 %	name:Wynwood Fox Imperial Red Ale; factoryWynwood Brewing Company; style:American Strong Ale; ABV:7.70 %	different
name:Bourbon Barrel Aged Panama Red Ale; factoryFlossmoor Station Restaurant & Brewery; style:American Amber / Red Ale; ABV:7.00 %	name:AleSmith Old Numbskull - Bourbon Barrel Aged; factoryAleSmith Brewing Company; style:Barley Wine; ABV:11 %	different
